129,99,100,98,99,100,101,99,98,101,101,99,99,98,101,101,101,99,100,100,100,129,100,101,98,100,101,99,100,101,98,99,100,100,99,98,101,100,101,98,99,100,129,98,100,101,98,98,129,100,101,98,100,101,98,100,98,98,100,101,98,100,131,100,98,101,100,98,101,100,99,99,99,99,99,99,99,99,99,99,99,99,99,99,99,99,99,99,99,99,99,99,99,65,99,99,99,99,99,99
111,1,1,1,1,1,1,1,1,1,1,1,1,1,1,1,1,1,1,1,1,111,1,1,1,1,1,1,1,1,1,1,1,1,1,1,1,1,1,1,1,1,111,1,1,1,1,1,1,1,1,1,1,1,1,1,1,1,1,1,1,1,131,1,1,1,1,1,1,1,1,1,1,1,1,1,1,1,1,1,1,1,1,1,1,131,1,1,1,1,1,1,1,36,1,1,1,1,15,1
49,17,2,1,1,1,1,1,1,1,1,1,1,1,1,1,1,1,1,1,1,111,1,1,1,1,1,1,1,1,4,1,1,1,1,1,1,1,4,1,1,1,49,20,5,1,1,1,1,1,1,1,1,1,1,1,1,1,1,4,1,1,131,1,1,1,1,1,1,1,1,1,1,1,1,1,1,1,1,1,1,1,1,1,1,1,1,1,1,1,1,1,1,36,1,1,1,1,15,1
129,102,115,117,116,118,102,108,1,1,1,1,1,1,1,1,1,1,1,1,1,111,1,1,1,1,1,1,103,104,104,104,107,104,104,104,107,104,104,104,105,1,111,104,104,104,105,1,102,1,1,1,1,1,1,1,106,102,102,102,108,1,131,1,1,1,1,1,1,1,1,1,1,1,1,1,1,1,1,1,1,1,1,1,1,1,1,1,1,1,1,1,1,65,135,136,137,136,136,136
129,100,100,101,101,65,98,99,102,102,102,108,1,1,1,4,1,1,1,1,1,111,108,1,1,1,1,1,1,1,1,1,1,1,1,1,1,1,1,1,1,1,111,1,1,1,1,1,111,1,1,1,1,4,1,106,135,138,131,135,138,1,131,1,1,1,1,1,1,1,1,1,1,1,1,1,1,1,1,1,1,1,1,1,1,1,1,1,4,1,1,1,1,1,1,1,1,1,1,131
111,1,1,1,1,33,1,1,123,99,98,127,102,115,117,116,117,118,102,105,1,129,113,104,104,105,1,1,1,1,1,1,1,1,1,1,1,1,1,1,1,19,49,1,1,1,1,1,111,1,106,104,104,104,104,104,100,99,98,100,125,1,131,1,1,1,1,106,102,102,1,1,102,102,108,1,1,106,102,102,102,108,1,1,106,102,102,102,102,102,102,108,1,106,102,102,102,102,102,111
111,1,1,4,1,33,1,1,1,1,1,1,123,101,98,100,98,99,125,1,1,111,125,1,1,1,1,1,1,4,1,1,1,106,115,116,117,117,117,116,118,102,129,1,1,106,102,102,111,1,111,1,1,1,1,1,1,1,1,1,1,1,131,1,1,1,106,135,136,136,136,136,136,137,136,1,1,136,137,136,136,136,1,1,136,137,136,136,136,136,138,131,1,131,109,109,109,109,109,111
129,102,102,102,102,65,1,1,1,1,1,1,1,1,1,1,1,1,1,1,1,111,1,1,1,1,1,1,103,104,104,104,102,111,101,98,99,100,98,101,100,98,125,1,1,123,101,101,125,1,111,1,1,1,1,1,1,1,1,1,1,1,131,1,1,103,100,100,100,99,99,98,99,99,125,1,1,123,98,99,99,125,1,1,123,99,99,99,99,99,99,131,1,131,109,109,109,109,109,111
111,99,101,100,98,98,105,1,1,1,1,1,1,1,1,5,1,1,1,1,106,111,1,1,1,1,1,1,1,1,1,1,1,111,1,1,1,1,1,1,1,1,1,1,1,1,1,1,1,1,111,1,1,106,102,102,102,102,102,102,102,102,131,1,1,1,1,1,1,1,1,1,1,1,1,1,1,1,1,1,1,1,1,1,1,1,1,1,1,1,1,131,1,131,113,113,113,113,113,111
111,1,1,1,1,1,1,1,1,1,5,1,1,106,115,116,116,117,118,102,102,102,102,104,104,105,1,1,1,5,1,1,1,111,1,1,1,1,1,1,1,1,1,1,4,1,1,1,1,1,111,1,106,135,136,138,131,135,136,136,137,138,131,108,1,1,1,1,1,1,1,1,1,1,1,1,1,1,1,1,1,1,1,1,1,1,1,1,1,1,1,131,1,131,113,113,113,113,113,111
49,18,1,1,1,1,1,1,106,115,116,118,102,113,99,100,98,99,100,109,109,109,125,1,1,1,1,1,1,106,102,105,1,111,1,1,1,1,1,106,102,102,102,102,102,102,108,1,1,1,111,1,131,135,136,138,131,135,136,137,137,138,131,133,108,1,1,1,1,1,1,1,1,1,1,1,1,1,1,1,1,1,1,1,1,1,1,1,1,1,1,131,1,131,113,113,113,113,113,111
129,102,102,108,1,1,1,1,65,100,98,100,100,125,1,1,1,1,1,99,98,100,1,1,1,1,1,1,103,98,127,1,1,65,1,1,1,1,106,113,99,98,100,99,100,101,125,1,1,1,65,1,123,98,99,99,98,99,99,99,98,99,99,99,104,104,104,104,105,1,1,103,104,104,104,104,105,1,1,103,104,104,104,104,104,104,104,104,105,1,1,129,1,131,130,130,130,130,130,111
129,109,109,109,108,1,1,1,34,1,1,1,1,1,1,1,1,1,1,1,1,1,1,1,1,1,1,1,1,1,1,1,1,35,1,1,1,106,113,109,1,1,1,1,1,1,1,1,1,1,37,1,1,1,1,1,1,1,1,1,1,1,1,1,1,1,1,1,1,1,1,1,1,1,1,1,1,1,1,1,1,1,1,1,1,1,1,1,1,1,103,131,1,131,130,130,130,130,130,111
109,109,109,109,109,108,1,1,34,1,1,1,1,1,1,1,112,1,4,1,1,1,1,1,106,102,108,1,1,1,1,1,1,35,1,1,106,102,113,49,21,4,1,1,10,1,1,1,1,1,37,1,1,1,1,1,1,1,1,1,1,1,1,1,1,1,1,1,1,1,1,1,1,1,1,1,1,1,1,1,1,1,1,1,1,1,1,1,1,1,1,131,16,131,130,130,130,130,130,111
129,109,109,109,109,109,102,102,65,102,102,102,102,102,102,102,102,102,102,102,102,102,102,102,102,102,102,102,102,102,102,102,102,65,102,102,113,113,113,113,102,102,102,102,102,102,102,102,102,102,65,102,102,102,102,102,102,102,102,102,102,102,102,102,102,102,102,102,102,102,102,102,102,102,102,102,102,102,102,102,102,102,102,102,102,102,102,102,102,102,102,131,1,131,130,130,130,130,130,129